1 1 1 1 1 1 1
1 4 3 0 0 1 1
1 0 2 1 0 0 1
1 0 2 0 5 0 1
1 5 0 0 0 1 1
1 1 1 1 1 1 1