1 1 1 1 1 1 1
1 1 1 0 0 1 1
1 4 0 5 2 1 1
1 0 0 0 2 0 1
1 0 1 5 0 0 1
1 0 0 0 0 0 1
1 1 1 1 1 1 1